11111111111111111111111111111111111111111111111111
11111111111111111111111111111111111111111111111111
11111111111111111111111111111111111111111111111111
11111111111111111111111111111111111111111111111111
11111111111111111111111111111111111111111111111111
11111111111111111111111111111111111111111111111111
11111111111111111111111111111111111111111111111111
11111111111111110000011111111111111111111111111111
11111111111111000000001111111111111111111111111111
11111111111111000000001111111111111111111111111111
11111111111111000000001111111111111111111111111111
11111111111111100000001111111111111111111111111111
11111111111111110000011111111111111111111111111111
11111111111111111100011111111111111111111111111111
11111111111111111110111111111111111111111111111111
11111111111111111110111111111111111111111111111111
11111111111111111110111111111111111111111111111111
11111111111111111110111111111111111111111111111111
11111111111111111110111111111111111111111111111111
11111111111111111110111111111111111111111111111111
10000000000000000000000000000001111111111111111111
10000000000000000000000000000000000000000011111111
10000000000000000000000000000000000000000001111111
10000000000000000000000000000000000000000000011111
10000000000000000000000000000000000000000000001111
10000000000000000000000000000000000000000000000011
10000000000000000000000000000000000000000000000001
10000000000000000000000000000000000000000000000001
10000000000000000000000000000000000000000000000001
11111111111111111111111111111111111111111111111111
